111111111111111
1P00000000000C1
1C01111011100C1
100010000010001
101110101110101
1C00001000000E1
111111111111111
